NO greystone.xpm
WE greystone.xpm




F 220,100,8
C 225,30,0

SO greystone.xpm
EA greystone.xpm


1111111111111111111111111
1000000000000000000000001
1000000000000000000010001
100000000000E000000000001
1000000000000000000000001
1000000000000000000010001
1111111111111111111111111
