NO greystone.xpm
WE greystone.xpm




F 220,100,8
C 225,30,0

SO greystone.xpm
EA greystone.xpm


1111111111111111111111111
1010000000000000000001001
100000100000W100000000001
1000000000100000001000001
1111111111111111111111111
