NO greystone.xpm
WE greystone.xpm


F 240,255,220
C 220,240,255

SO greystone.xpm
EA greystone.xpm

1111111111111111111111111
1000000000000000000000001
1000000000000000000000001
100000000000S000000000001
1000000000000000000000001
1000000000000000000000001
1111111111111111111111111
