NO textures/redbrick.xpm
SO textures/greystone.xpm

WE textures/wood.xpm
EA textures/purplestonetextures/.xpm


F 240,255,220
C 220,240,255


1111111111111111111111111
1000000000000000000000001
1000000000001000000000001
100000000000N000000000001
1000000000000000000000001
1000000000000000000000001
1000000000000000000000001
1111111111111111111111111
