NO greystone.xpm
WE greystone.xpm




F 220,100,8
C 225,30,0

SO greystone.xpm
EA greystone.xpm


        1111111111111111111111111
        100000000011000000000111111111
        1011000001110001101000000011111
        100100000000000010000000111111111111
11111111111111111111111111111111
111111111111111111111111111111111
111111111011000001110000000000001
100000000011000001111111111111111
11110110111111011100000010001
11110111111111011101010010001
11000000110111011100000010001  1111111
10000000000010011000000100011  1000001
10000000000000011010100100001  100E001
1000001110101011111111101111   1111111
1110111 1110101 1011110100001
1111111 111111111111 11111111
11
1111
11111
