NO greystone.xpm
WE greystone.xpm


F 240,255,220
C 220,240,255

SO greystone.xpm
EA greystone.xpm

1111111111111111111111111
1000000000000000000000001
1000000000000000000010001
100000000000E000000000001
1000000000000000000000001
1000000000000000000010001
1111111111111111111111111
