

NO textures/redbrick.xpm

EA textures/purplestone.xpm

SO textures/greystone.xpm

WE textures/wood.xpm

F 240,255,220
C 220,240,255


11111111111111111111111
10000001100000000000001
10000000000011100000001
100000000000N0000000001
10000000000000000000001
11111111111111111111111
