NO textures/redbrick.xpm
EA textures/purplestone.xpm

SO textures/greystone.xpm
WE textures/wood.xpm

F 240,255,220
C 220,240,255


1111111  1111111111111111111
1000000110000000000000000001
1000000000001110000000000001
100000000000N000000000000001
1000000000000000000000000001
1111111111111111111111111111
